F 100,1,1
NO ./textures/path_to_the_north_texture
C 2,88,125
SO ./textures/path_to_the_south_texture
WE ./textures/path_to_the_west_texture
EA ./textures/row.xpm

        11111111111111111111111111111111111111
        100000000110000000000000000000000000001
        1011010001110000000000000000000000000N1
        101101000111000000000000000000000000001
        10010000000000000010000001111111111111
1111111110110000011110000000000001
1000000000110000011101111111111111
11110111111111011100000010001
11110111111111011101010010001
11000000110101011100000010001
10000000000000001100000010001
10000000000000001101010010001
1100000111010101111101111000111
11110111 1110101 101111010001
11111111 1111111 111111111111