NO ./texturs/NO.xpm
SO ./texturs/SO.xpm
WE ./texturs/WE.xpm
EA ./texturs/EA.xpm
C 3,2,3
F 28,109,208


        1111111111111111111111111
        1000000000110000000000001
        1011000001110000000000001
        1001000000000000000000001
1111111110110N0001110000000000001
100000000011000001110111111111111
11110111111111011100000010001
11110111111111011101010000001
11000000110101011100000000001
10000000000000000000000000001
1000000000000000110101000000111
11000001110101011111011110001111
11110111 1110101 101111010001
11111111 1111111 111111111111