NO ./path_to_the_north_texture
SO ./path_to_the_south_texture
WE ./path_to_the_west_texture
EA ./path_to_the_east_texture
F 100,1,1
C 2,88,125

        1111111111111111111111111111111111111111111111111111111111111111
        10000000011000000000000000000000000000000000000000000000000000001
        1011010001110000000000000000000000000000000000000000000E010000001
        10110100011100000000000000000000000000000000000000000000000000001
        1001000000000000001000000111111111111111111111111111111111111111
1111111110110000011110000000000001
1000000000110000011101111111111111
11110111111111011100000010001
11110111111111011101010010001
11000000110101011100000010001
10000000000000001100000010001
10000000000000001101010010001
1100000111010101111101111000111
11110111 1110101 101111010001
11111111 1111111 111111111111