NO ./texturs/NO.xpm
SO ./texturs/SO.xpm
WE ./texturs/WE.xpm
EA ./texturs/EA.xpm
C 3,2,3
F 28,109,208


        1111111111111111111111111
        1000000000110000000000001
        1011000001110000000000001
        1001000000000000000000001
111111111011000001110000000000001
100000000011000001110111111111111
1111011111111101110000001000111111111
1111011111111101110101001000111111111
1100000011010101110000001S00011111111
10000000000000001100000010001
10000000000000001101010010001
110000011101010111111111000111
11110111 1110101 101111010001
11111111 1111111 111111111111