NO ./texturs/NO.xpm
SO ./texturs/SO.xpm
WE ./texturs/WE.xpm
EA ./texturs/EA.xpm
C 3,2,3
F 28,109,208


1111111111111111111111111111111111111111111111111111111
111111111111100000000000100000000000000000000000000000011
10000000000E00000000000010000000000000000000000000000001
1111111000000001111111111111111111111111111111111111111
1111111110000001
1100000011000001
1000000000000001
1000000000000001
1100000111000001
1111011111100001
1111111111100001
1111111111100001
1111111111111001
1111111111111111